20 9 1.0
*.+..............x.@
*..................@
....................
..+..............x..
#.+..............x.$
..+..............x..
....................
*..................@
*.+..............x.@
