20 9 0.75
*.+................@
*.+................@
....................
..+..............x..
#.+..............x.$
..+..............x..
....................
*.+................@
*.+................@
