20 9 2.0
*................x.@
*..................@
....................
.................x..
#................x.$
.................x..
....................
*..................@
*................x.@
