20 9 2.5
...*.............x.@
*................x.@
....................
.................x..
#................x.$
.................x..
....................
*................x.@
...*.............x.@
